MainPanel	Assets\ManagedResources\Prefabs\MainPanel.prefab
MainScene	Assets\ManagedResources\Prefabs\MainScene.prefab
defaultblade	Assets\ManagedResources\Prefabs\Blade\defaultblade.prefab
fireblade	Assets\ManagedResources\Prefabs\Blade\fireblade.prefab
hugeAxe	Assets\ManagedResources\Prefabs\Blade\hugeAxe.prefab
hugeblade	Assets\ManagedResources\Prefabs\Blade\hugeblade.prefab
ironblade	Assets\ManagedResources\Prefabs\Blade\ironblade.prefab
lightningblade	Assets\ManagedResources\Prefabs\Blade\lightningblade.prefab
miasmablade	Assets\ManagedResources\Prefabs\Blade\miasmablade.prefab
snowblade	Assets\ManagedResources\Prefabs\Blade\snowblade.prefab
fxx_bingzhangjineng	Assets\ManagedResources\Prefabs\effs\fxx_bingzhangjineng.prefab
fxx_dimian	Assets\ManagedResources\Prefabs\effs\fxx_dimian.prefab
fxx_fire01	Assets\ManagedResources\Prefabs\effs\fxx_fire01.prefab
fxx_lightning01	Assets\ManagedResources\Prefabs\effs\fxx_lightning01.prefab
fxx_miasma	Assets\ManagedResources\Prefabs\effs\fxx_miasma.prefab
fxx_snow01	Assets\ManagedResources\Prefabs\effs\fxx_snow01.prefab
fx_bingzhang	Assets\ManagedResources\Prefabs\effs\fx_bingzhang.prefab
fx_boss_chongci_xuli	Assets\ManagedResources\Prefabs\effs\fx_boss_chongci_xuli.prefab
fx_boss_erjieduan	Assets\ManagedResources\Prefabs\effs\fx_boss_erjieduan.prefab
fx_boss_erjieduan_baofa	Assets\ManagedResources\Prefabs\effs\fx_boss_erjieduan_baofa.prefab
fx_boss_fire01	Assets\ManagedResources\Prefabs\effs\fx_boss_fire01.prefab
fx_boss_miasma	Assets\ManagedResources\Prefabs\effs\fx_boss_miasma.prefab
fx_chongci	Assets\ManagedResources\Prefabs\effs\fx_chongci.prefab
fx_huixue	Assets\ManagedResources\Prefabs\effs\fx_huixue.prefab
fx_huoqudaoju	Assets\ManagedResources\Prefabs\effs\fx_huoqudaoju.prefab
fx_jiasu_trail	Assets\ManagedResources\Prefabs\effs\fx_jiasu_trail.prefab
fx_juese_shouji	Assets\ManagedResources\Prefabs\effs\fx_juese_shouji.prefab
fx_kuangbao	Assets\ManagedResources\Prefabs\effs\fx_kuangbao.prefab
fx_pindao	Assets\ManagedResources\Prefabs\effs\fx_pindao.prefab
fx_shandianjingu	Assets\ManagedResources\Prefabs\effs\fx_shandianjingu.prefab
fx_snow02	Assets\ManagedResources\Prefabs\effs\fx_snow02.prefab
fx_xiaoguaisiwang	Assets\ManagedResources\Prefabs\effs\fx_xiaoguaisiwang.prefab
fx_xuanyun	Assets\ManagedResources\Prefabs\effs\fx_xuanyun.prefab
role_smoke	Assets\ManagedResources\Prefabs\effs\role_smoke.prefab
level1	Assets\ManagedResources\Prefabs\Level\level1.prefab
level10	Assets\ManagedResources\Prefabs\Level\level10.prefab
level11	Assets\ManagedResources\Prefabs\Level\level11.prefab
level12	Assets\ManagedResources\Prefabs\Level\level12.prefab
level13	Assets\ManagedResources\Prefabs\Level\level13.prefab
level14	Assets\ManagedResources\Prefabs\Level\level14.prefab
level15	Assets\ManagedResources\Prefabs\Level\level15.prefab
level16	Assets\ManagedResources\Prefabs\Level\level16.prefab
level17	Assets\ManagedResources\Prefabs\Level\level17.prefab
level18	Assets\ManagedResources\Prefabs\Level\level18.prefab
level19	Assets\ManagedResources\Prefabs\Level\level19.prefab
level2	Assets\ManagedResources\Prefabs\Level\level2.prefab
level20	Assets\ManagedResources\Prefabs\Level\level20.prefab
level21	Assets\ManagedResources\Prefabs\Level\level21.prefab
level22	Assets\ManagedResources\Prefabs\Level\level22.prefab
level23	Assets\ManagedResources\Prefabs\Level\level23.prefab
level24	Assets\ManagedResources\Prefabs\Level\level24.prefab
level25	Assets\ManagedResources\Prefabs\Level\level25.prefab
level26	Assets\ManagedResources\Prefabs\Level\level26.prefab
level27	Assets\ManagedResources\Prefabs\Level\level27.prefab
level28	Assets\ManagedResources\Prefabs\Level\level28.prefab
level29	Assets\ManagedResources\Prefabs\Level\level29.prefab
level3	Assets\ManagedResources\Prefabs\Level\level3.prefab
level30	Assets\ManagedResources\Prefabs\Level\level30.prefab
level31	Assets\ManagedResources\Prefabs\Level\level31.prefab
level32	Assets\ManagedResources\Prefabs\Level\level32.prefab
level33	Assets\ManagedResources\Prefabs\Level\level33.prefab
level34	Assets\ManagedResources\Prefabs\Level\level34.prefab
level35	Assets\ManagedResources\Prefabs\Level\level35.prefab
level36	Assets\ManagedResources\Prefabs\Level\level36.prefab
level37	Assets\ManagedResources\Prefabs\Level\level37.prefab
level38	Assets\ManagedResources\Prefabs\Level\level38.prefab
level39	Assets\ManagedResources\Prefabs\Level\level39.prefab
level4	Assets\ManagedResources\Prefabs\Level\level4.prefab
level40	Assets\ManagedResources\Prefabs\Level\level40.prefab
level41	Assets\ManagedResources\Prefabs\Level\level41.prefab
level42	Assets\ManagedResources\Prefabs\Level\level42.prefab
level43	Assets\ManagedResources\Prefabs\Level\level43.prefab
level44	Assets\ManagedResources\Prefabs\Level\level44.prefab
level45	Assets\ManagedResources\Prefabs\Level\level45.prefab
level46	Assets\ManagedResources\Prefabs\Level\level46.prefab
level47	Assets\ManagedResources\Prefabs\Level\level47.prefab
level48	Assets\ManagedResources\Prefabs\Level\level48.prefab
level49	Assets\ManagedResources\Prefabs\Level\level49.prefab
level5	Assets\ManagedResources\Prefabs\Level\level5.prefab
level50	Assets\ManagedResources\Prefabs\Level\level50.prefab
level51	Assets\ManagedResources\Prefabs\Level\level51.prefab
level52	Assets\ManagedResources\Prefabs\Level\level52.prefab
level53	Assets\ManagedResources\Prefabs\Level\level53.prefab
level54	Assets\ManagedResources\Prefabs\Level\level54.prefab
level55	Assets\ManagedResources\Prefabs\Level\level55.prefab
level56	Assets\ManagedResources\Prefabs\Level\level56.prefab
level57	Assets\ManagedResources\Prefabs\Level\level57.prefab
level58	Assets\ManagedResources\Prefabs\Level\level58.prefab
level59	Assets\ManagedResources\Prefabs\Level\level59.prefab
level6	Assets\ManagedResources\Prefabs\Level\level6.prefab
level60	Assets\ManagedResources\Prefabs\Level\level60.prefab
level61	Assets\ManagedResources\Prefabs\Level\level61.prefab
level62	Assets\ManagedResources\Prefabs\Level\level62.prefab
level63	Assets\ManagedResources\Prefabs\Level\level63.prefab
level64	Assets\ManagedResources\Prefabs\Level\level64.prefab
level65	Assets\ManagedResources\Prefabs\Level\level65.prefab
level66	Assets\ManagedResources\Prefabs\Level\level66.prefab
level67	Assets\ManagedResources\Prefabs\Level\level67.prefab
level68	Assets\ManagedResources\Prefabs\Level\level68.prefab
level69	Assets\ManagedResources\Prefabs\Level\level69.prefab
level7	Assets\ManagedResources\Prefabs\Level\level7.prefab
level70	Assets\ManagedResources\Prefabs\Level\level70.prefab
level71	Assets\ManagedResources\Prefabs\Level\level71.prefab
level72	Assets\ManagedResources\Prefabs\Level\level72.prefab
level73	Assets\ManagedResources\Prefabs\Level\level73.prefab
level74	Assets\ManagedResources\Prefabs\Level\level74.prefab
level75	Assets\ManagedResources\Prefabs\Level\level75.prefab
level76	Assets\ManagedResources\Prefabs\Level\level76.prefab
level77	Assets\ManagedResources\Prefabs\Level\level77.prefab
level78	Assets\ManagedResources\Prefabs\Level\level78.prefab
level79	Assets\ManagedResources\Prefabs\Level\level79.prefab
level8	Assets\ManagedResources\Prefabs\Level\level8.prefab
level80	Assets\ManagedResources\Prefabs\Level\level80.prefab
level9	Assets\ManagedResources\Prefabs\Level\level9.prefab
crazeProp	Assets\ManagedResources\Prefabs\prop\crazeProp.prefab
defaultBladeProp	Assets\ManagedResources\Prefabs\prop\defaultBladeProp.prefab
defaultBladeProp2	Assets\ManagedResources\Prefabs\prop\defaultBladeProp2.prefab
fireBladeProp	Assets\ManagedResources\Prefabs\prop\fireBladeProp.prefab
fleetfootedProp	Assets\ManagedResources\Prefabs\prop\fleetfootedProp.prefab
iceBladeProp	Assets\ManagedResources\Prefabs\prop\iceBladeProp.prefab
lightningBladeProp	Assets\ManagedResources\Prefabs\prop\lightningBladeProp.prefab
loveProp	Assets\ManagedResources\Prefabs\prop\loveProp.prefab
miasmaBladeProp	Assets\ManagedResources\Prefabs\prop\miasmaBladeProp.prefab
swordProp	Assets\ManagedResources\Prefabs\prop\swordProp.prefab
axeBoss	Assets\ManagedResources\Prefabs\Role\axeBoss.prefab
axeBoss2	Assets\ManagedResources\Prefabs\Role\axeBoss2.prefab
Bingmodaoshi	Assets\ManagedResources\Prefabs\Role\Bingmodaoshi.prefab
bladeBoss	Assets\ManagedResources\Prefabs\Role\bladeBoss.prefab
Dafeilong	Assets\ManagedResources\Prefabs\Role\Dafeilong.prefab
gadiator	Assets\ManagedResources\Prefabs\Role\gadiator.prefab
gadiator2	Assets\ManagedResources\Prefabs\Role\gadiator2.prefab
ironBoss	Assets\ManagedResources\Prefabs\Role\ironBoss.prefab
knight	Assets\ManagedResources\Prefabs\Role\knight.prefab
onion	Assets\ManagedResources\Prefabs\Role\onion.prefab
player	Assets\ManagedResources\Prefabs\Role\player.prefab
circleDmg	Assets\ManagedResources\Prefabs\Skill\circleDmg.prefab
circleGuide	Assets\ManagedResources\Prefabs\Skill\circleGuide.prefab
fanGuide	Assets\ManagedResources\Prefabs\Skill\fanGuide.prefab
fx_bingzhangjineng	Assets\ManagedResources\Prefabs\Skill\fx_bingzhangjineng.prefab
fx_dimian	Assets\ManagedResources\Prefabs\Skill\fx_dimian.prefab
fx_fire01	Assets\ManagedResources\Prefabs\Skill\fx_fire01.prefab
fx_fire_boss	Assets\ManagedResources\Prefabs\Skill\fx_fire_boss.prefab
fx_lightning01	Assets\ManagedResources\Prefabs\Skill\fx_lightning01.prefab
fx_miasma	Assets\ManagedResources\Prefabs\Skill\fx_miasma.prefab
fx_miasma_boss	Assets\ManagedResources\Prefabs\Skill\fx_miasma_boss.prefab
fx_snow01	Assets\ManagedResources\Prefabs\Skill\fx_snow01.prefab
rushGuide	Assets\ManagedResources\Prefabs\Skill\rushGuide.prefab
dmgPrefab	Assets\ManagedResources\Prefabs\UI\dmgPrefab.prefab
hpSlider	Assets\ManagedResources\Prefabs\UI\hpSlider.prefab
Bg1	Assets\ManagedResources\Prefabs\map\desert\Bg1.prefab
cactus_desert	Assets\ManagedResources\Prefabs\map\desert\cactus_desert.prefab
stone_desert1	Assets\ManagedResources\Prefabs\map\desert\stone_desert1.prefab
stone_desert2	Assets\ManagedResources\Prefabs\map\desert\stone_desert2.prefab
stone_desert3	Assets\ManagedResources\Prefabs\map\desert\stone_desert3.prefab
stone_desert4	Assets\ManagedResources\Prefabs\map\desert\stone_desert4.prefab
stone_desert5	Assets\ManagedResources\Prefabs\map\desert\stone_desert5.prefab
trunk_desert	Assets\ManagedResources\Prefabs\map\desert\trunk_desert.prefab
Bg2	Assets\ManagedResources\Prefabs\map\gorge\Bg2.prefab
crystal_canyon	Assets\ManagedResources\Prefabs\map\gorge\crystal_canyon.prefab
crystal_canyon2	Assets\ManagedResources\Prefabs\map\gorge\crystal_canyon2.prefab
magma_canyon	Assets\ManagedResources\Prefabs\map\gorge\magma_canyon.prefab
stone_canyon1	Assets\ManagedResources\Prefabs\map\gorge\stone_canyon1.prefab
stone_canyon2	Assets\ManagedResources\Prefabs\map\gorge\stone_canyon2.prefab
stone_canyon3	Assets\ManagedResources\Prefabs\map\gorge\stone_canyon3.prefab
stone_canyon4	Assets\ManagedResources\Prefabs\map\gorge\stone_canyon4.prefab
Bg3	Assets\ManagedResources\Prefabs\map\grass\Bg3.prefab
block_grassland1_ob	Assets\ManagedResources\Prefabs\map\grass\block_grassland1_ob.prefab
block_grassland2_ob	Assets\ManagedResources\Prefabs\map\grass\block_grassland2_ob.prefab
block_grassland3_ob	Assets\ManagedResources\Prefabs\map\grass\block_grassland3_ob.prefab
stone_grassland1_ob	Assets\ManagedResources\Prefabs\map\grass\stone_grassland1_ob.prefab
stone_grassland2_ob	Assets\ManagedResources\Prefabs\map\grass\stone_grassland2_ob.prefab
stone_grassland3_ob	Assets\ManagedResources\Prefabs\map\grass\stone_grassland3_ob.prefab
wood_grassland1_ob	Assets\ManagedResources\Prefabs\map\grass\wood_grassland1_ob.prefab
wood_grassland2_ob	Assets\ManagedResources\Prefabs\map\grass\wood_grassland2_ob.prefab
wood_grassland3_ob	Assets\ManagedResources\Prefabs\map\grass\wood_grassland3_ob.prefab
Bg4	Assets\ManagedResources\Prefabs\map\snow\Bg4.prefab
pine_snow	Assets\ManagedResources\Prefabs\map\snow\pine_snow.prefab
spar_snow	Assets\ManagedResources\Prefabs\map\snow\spar_snow.prefab
spar_snow2	Assets\ManagedResources\Prefabs\map\snow\spar_snow2.prefab
stone_snow1	Assets\ManagedResources\Prefabs\map\snow\stone_snow1.prefab
stone_snow2	Assets\ManagedResources\Prefabs\map\snow\stone_snow2.prefab
stone_snow3	Assets\ManagedResources\Prefabs\map\snow\stone_snow3.prefab
